################
#   #        x #
# o ##    x    #
#              #
############   #
#     #    x   #
#   #####      #
#   #   ###    #
#              #
################