################
#   #          #
# o ##         #
#              #
############   #
#     #        #
#   #####      #
#   #   ###    #
#              #
################